1111111111111111111111111
10000P0000C11100000010001
1001110101001000101000101
1101010000E01101000110111
1010010010010000000000111
1000000000000010010100001
1001010001100101111000001
1101000101100000011000111
1010001010100010001000001
1000001011000001100000101
11100010010X1100001100001
1010000000110101100000001
1111111111111111111111111