11111111111111111111111
1X0000000000000000000P1
10000000000000000000001
10000000000000000000001
10000000000000000000001
10000000000000000000001
10000000000000000000001
10000000000000000000001
10000000000X00000000001
10000000000000000000001
10000000000000000000001
10000000000000000000001
1E000000000000000000001
11111111111111111111111