111111111111111111111111111
100000000000X0001C0000000E1
101011101010111010101011111
1C1010000000000000000000001
1010101011111C1110101010101
100000100000000000000000001
101010101110101010101010101
10000010C0100000001000C0001
101110101010101110101010101
10001C000010001000001000001
10101P111010101011101010101
10100000000000100C000000001
101010101111101010101010101
100010000000000000001000001
101010101C10101010101111101
100000101000100000000X00001
101010101010101010101010101
100000000000000000001000001
111111111111111111111111111
