111111111111111111111111111111111
100C00000000000000000000000000001
101P11101010111010101011101010101
101000000000000010000000001000001
101010101010101011101110101010111
101000000000000000000X00000010001
1C1011101010101110101110101010101
100000000010100000000000001000001
101110101110101010101011101010101
1000000000000000C000101000000C001
101010101010101010101010101111101
1010C0100000001000001000000010001
101110101C101010101C10101010111C1
100000000000000000100000000000001
111011111110101011101010101010101
100010000000001000000000000000001
1011101010101010101C1011101010101
101000C01010001010001000100010001
101011101011101010101010101010101
1C0000000000001000000010001000001
1010101010111010101010101X1010101
10000000000000001000X0000000000E1
111111111111111111111111111111111
