111111111111111111111111111111111111111
1E0000000000000000000000000000000000001
101010101010111011111011101010101010101
1000000C000000000000001000001000C01C001
101011101010101010101010101111111010101
100000001000001000000000000000000000001
101010101X10101010101010101011101110101
100010100C00001010000000000000000000001
10101C111011101010101010111110101010101
100000000000000010000000000000000010001
10101010101011101C101010101110101110101
100000100010000000000000000000001000101
101010111011101011101010101010101010101
10X000000000001000100010000000000000001
101010101010101010101110101C101010101C1
1000001000000000100000001000000000000P1
1010101C1010101011101010101011101010101
100010000000000000000000000010000000001
101010101011101010111010101010101010101
10100010000C0000000000001000100010C0101
101010101010111110101010101010101010101
101010000000000000001000000000100000001
1011101010111010101010111C1010101110101
100000000000001000C00000000000100000001
1010101X1010101010101011101010101010101
100000000000000000X000000C0010000000001
111111111111111111111111111111111111111
