111111111111111111111111111111111111111111111
1000000000000000000X0000000000000000000000001
101010101011101010101C1110101011111X101010101
101000000C00000000100000000000000000000000001
101010101010101011101010101010101111111010101
100000000000000X00001010100000000000000010001
111C101010101011101X1010101110101010101010101
100000000010000000001010000000000000100000001
10101010101010101X101010101010111010101110101
101010000000000000100C10100010000000000010001
101010101010101010111010101C10101010101010101
1000100000001000000000000000100000000010C0001
10111010111C101010101110101010101C10101010101
101000000000001000100000000000000P00101000001
10111010101010101C10111010101011101110111C111
10000000000000000010000000100C000000000000001
101010101C10111010101110101010101010101010111
100000100000000000000010000000100000100000001
101010101010101011101110101110101011101110101
100000000000000000000000100000000000000000001
101011101C10101011111010101010101110101010101
100000000000000000000010000010100000100000001
1110101110101111101010101010101010101011101C1
1000000000000000001010000000000000000C1000001
101110111010101010101011101110101110101010101
100000000000100000000000001000000000001000001
101010111011101010101010101011111010101010101
101010000010000000000000100000000000C01000101
101011111C10101010101010101010101011101010101
1E000000000000000010000000000C100000000000001
111111111111111111111111111111111111111111111
