111111111111111111111111111111111111111111111111111
1000000000C0000000100000001000100010000000000000001
101010101110111010101010101010101010101010101011101
1000000C0000000000100000100000000000000000100000001
101011111010101010101011101010111110111010101010111
10000000000000100000000000C000001000000000100000001
101010101010101011101010111011101010101111101010101
10001000001010000000101000C0000000000X0000000000101
101011101010111010101010101010101010101C10111110101
100000000010000010000000000000000000001000001000001
101C10111111101011111010101010111010101111101010101
1000100000000000001000001000000000C0100000000010001
101011111010101010101010101111101010111010101011101
1000100000000000000000000010001010000C0000X00000001
101010101010101110111010101010101110101011101111101
10001010000C100000100010000010001000000000000000101
10101010101P10101010101010101010101010111C101010101
10001000000000000000100C00000010100000000000C010001
1010101011101010111010101C1010101010101110101010101
100000001000101000000000001000000000000000000010001
111C10101C10101010101010101010101010101110101010101
100000001000000000000000000000000010001000000000101
101C10111010101110101011101010111010101111101010101
100010000C10001000000000000000000000000C00000000001
101010101010101110101010101010101010101110101010101
100010000000000000001000C000000000001000000010001C1
1010101011101010101010101010101C1010111010101010101
10001000000000000010100000001X100010000000000000001
101011101011101110101010101010101010111011101010101
1X000000000000100010000010000000000000000000001X001
10101010101010101010101010101010101010101C101010101
101010000000000000000000001000000000000000000X00101
101010101110101010101110101110101011101010101010101
1000000000000000000000001000000000000000000000000E1
111111111111111111111111111111111111111111111111111
