11111111111111111111111111111111111111111111111111111111111
100000000000000000000000000000C000X0000000100000000000X0001
10101010101010101011101010111011101011111010101110111010101
1010000000100010001000100000000000000C1000000000101000101E1
10101010111011101010101010101111101010101010101110101010111
10001010000000001000000000000C00000000000000000010000000001
10101010101010101011101010101010101010101010111C10101010101
10001010000000C0000000000000101000X000100000101000101000001
10101011101010111010101110111010111010101110101010101110101
10000000000C00000000000010001000000000000000000000100000001
10101110111011101110111010111110101010101010101X10101010101
100000000000001000000000000000000000000X1000000000000000001
101010111C11101110101C111010101010101010101111101X101010101
10000000000000000010100000000C00000010000000001000000000001
10101010101010101110101110101011111010101010111010101010101
10000000100000000000100000100000100000001000000010001010001
10101110101010101110101010101011101110101010101110111010101
10000010100000100000001000000000000000000000000000000000001
10101010101010101010101010101010101010111010101011101010101
100000000000000000001000000000000000100000000C1000001000101
10101110101011111010101110101010101010101010111110101010101
100000C00C00000C0010100000000000000000100000100000000C00001
101010101010101011101010111010101010101C1010101010101010101
1000101000000000001000001000100000X000100010001010000000001
10101010101111101010101110101110101110101111101010101010101
100010100000000010000010000000000000000000000000100000001C1
10101010101010111C1111101110101110101011111110101C101010101
10000000C00000000010000010000010000000000000000000101000001
1C101010101011101010111010111010101110101010101010101011101
1P000010000010000000000000001000C00000000000000010001000001
10101010111010101110101010101010111010111010101010111110101
1000000000000010001000000000000000001C001010000000000000001
10101010101110101010111010101111101011101010111010111011101
1000000000000000000010000010000000C0001000100000001C0010001
101110101010101110101C1010101010101010101110101010101010101
100000000000000010000000000C0010000000100000000000000000001
10101010101010101110101010101010101011111110101110101011101
10001000001010000000000000000000100000000010000000001000101
10101010101010101010101011101010101011111010101011101010101
10000000000000000000000000000000000000001000000000000010001
11111111111111111111111111111111111111111111111111111111111
